022222200000000
002000200202020
002000222222220
032020200000020
002022220300020
002000020222220
002000020020000
002002010020000
002002000020000
002222220020000
000020022222240
000020020020000
022220020020050
000020000022220
002222224000000