000000000000000000000
002222000030022200000
002002220022220200000
002002000002000200000
002222220002222202000
002000020022000002000
002000020020002222040
002222222220002002220
000202000020002200020
000202240020000200000
322222000010000222223
002000000022222200000
002000022220000200004
002222220020000220002
000000020022220022022
000000020020022200020
000002222222220200022
000002000000022222002
000002020022220002002
004222220030000222222
000000000060000000002