000040000
000022200
022220000
000020000
032212000
000022220
020020200
022220220
520000024