4:6:0:0:0:0:0:0:0:0:0:6:4
6:0:0:0:0:0:504:0:0:0:0:0:6
0:0:0:0:0:0:0:0:0:0:0:0:0
4:0:0:3:0:0:0:0:0:3:0:0:4
0:0:0:0:0:0:0:0:0:0:0:0:0
6:0:0:0:0:0:0:0:0:0:0:0:6
4:6:0:0:0:0:0:0:0:0:0:6:4